Rk,Player,Pos,Age,Tm,G,GS,MP,FG,FGA,FG%,3P,3PA,3P%,2P,2PA,2P%,eFG%,FT,FTA,FT%,ORB,DRB,TRB,AST,STL,BLK,TOV,PF,PTSâ–¼
1,James Harden\hardeja01,SG,28,HOU,27,27,962,259,569,.455,115,292,.394,144,277,.520,.556,217,251,.865,15,124,139,251,50,12,117,70,850
2,LeBron James\jamesle01,PF,33,CLE,29,29,1081,314,543,.578,58,141,.411,256,402,.637,.632,128,169,.757,36,206,242,264,42,33,119,49,814
3,DeMarcus Cousins\couside01,C,27,NOP,30,30,1064,271,573,.473,70,194,.361,201,379,.530,.534,175,239,.732,63,304,367,153,45,45,157,110,787
4,Giannis Antetokounmpo\antetgi01,PF,23,MIL,26,26,982,286,522,.548,13,45,.289,273,477,.572,.560,192,251,.765,59,215,274,116,46,41,74,90,777
5,Damian Lillard\lillada01,PG,27,POR,28,28,1039,231,546,.423,80,228,.351,151,318,.475,.496,188,202,.931,27,110,137,170,28,13,82,48,730
6,Kyrie Irving\irvinky01,PG,25,BOS,29,29,933,258,522,.494,68,173,.393,190,349,.544,.559,122,138,.884,14,73,87,142,39,10,66,64,706
7,Bradley Beal\bealbr01,SG,24,WAS,29,29,1019,247,543,.455,64,179,.358,183,364,.503,.514,127,161,.789,25,96,121,100,33,14,70,56,685
8,Victor Oladipo\oladivi01,SG,25,IND,28,28,959,246,520,.473,77,181,.425,169,339,.499,.547,114,146,.781,17,135,152,114,51,29,92,69,683
9,DeMar DeRozan\derozde01,SG,28,TOR,27,27,927,230,471,.488,17,67,.254,213,404,.527,.506,171,212,.807,21,102,123,135,34,4,66,47,648
10,Russell Westbrook\westbru01,PG,29,OKC,28,28,1023,222,578,.384,50,159,.314,172,419,.411,.427,142,203,.700,48,223,271,281,56,3,134,74,636
11,Anthony Davis\davisan02,PF,24,NOP,25,25,883,231,406,.569,15,43,.349,216,363,.595,.587,153,192,.797,59,207,266,64,27,50,56,47,630
12,LaMarcus Aldridge\aldrila01,PF,32,SAS,28,28,934,243,495,.491,16,45,.356,227,450,.504,.507,126,148,.851,96,134,230,60,15,31,41,66,628
13,Kevin Durant\duranke01,SF,29,GSW,24,24,827,234,445,.526,59,145,.407,175,300,.583,.592,100,114,.877,14,155,169,128,17,51,86,54,627
14,Kristaps Porzingis\porzikr01,PF,22,NYK,24,24,764,218,469,.465,47,119,.395,171,350,.489,.515,128,151,.848,28,131,159,30,14,50,55,63,611
15,Devin Booker\bookede01,SG,21,PHO,25,25,851,213,470,.453,62,162,.383,151,308,.490,.519,120,138,.870,14,99,113,102,23,8,79,75,608
16,Stephen Curry\curryst01,PG,29,GSW,23,23,750,192,406,.473,83,218,.381,109,188,.580,.575,139,149,.933,15,102,117,151,40,4,67,57,606
17,Klay Thompson\thompkl01,SG,27,GSW,29,29,975,237,469,.505,101,214,.472,136,255,.533,.613,30,34,.882,13,109,122,74,19,18,50,52,605
18,Karl-Anthony Towns\townska01,C,22,MIN,29,29,1026,222,418,.531,37,102,.363,185,316,.585,.575,111,133,.835,82,261,343,53,24,42,63,104,592
19,Kemba Walker\walkeke02,PG,27,CHO,26,26,919,188,439,.428,63,177,.356,125,262,.477,.500,138,160,.863,14,81,95,156,23,6,54,38,577
20,C.J. McCollum\mccolcj01,SG,26,POR,27,27,989,215,475,.453,66,152,.434,149,323,.461,.522,77,87,.885,15,96,111,74,26,10,56,67,573
21,T.J. Warren\warretj01,SF,24,PHO,30,30,942,229,477,.480,9,48,.188,220,429,.513,.490,93,121,.769,60,108,168,38,25,20,42,70,560
22,Joel Embiid\embiijo01,C,23,PHI,23,23,723,192,392,.490,16,61,.262,176,331,.532,.510,155,192,.807,54,199,253,81,15,44,92,83,555
23,Khris Middleton\middlkh01,SF,26,MIL,27,27,1001,199,426,.467,52,145,.359,147,281,.523,.528,96,107,.897,16,128,144,124,34,2,61,91,546
24,Kevin Love\loveke01,C,29,CLE,28,28,823,174,369,.472,57,144,.396,117,225,.520,.549,139,159,.874,70,223,293,53,19,12,54,62,544
25,Lou Williams\willilo02,SG,31,LAC,27,6,828,179,399,.449,67,168,.399,112,231,.485,.533,119,133,.895,15,61,76,130,25,4,73,36,544
26,Jrue Holiday\holidjr01,PG,27,NOP,30,30,1111,217,448,.484,50,150,.333,167,298,.560,.540,60,73,.822,17,115,132,168,39,14,82,69,544
27,Marc Gasol\gasolma01,C,33,MEM,29,29,1015,186,447,.416,41,122,.336,145,325,.446,.462,129,156,.827,37,210,247,118,17,42,92,69,542
28,Jimmy Butler\butleji01,SG,28,MIN,27,27,1008,191,413,.462,32,89,.360,159,324,.491,.501,121,142,.852,34,117,151,131,49,9,50,38,535
29,Andrew Wiggins\wiggian01,SF,22,MIN,29,29,1069,201,458,.439,39,125,.312,162,333,.486,.481,93,146,.637,32,83,115,52,34,17,54,52,534
30,Harrison Barnes\barneha02,PF,25,DAL,29,29,1014,195,445,.438,33,102,.324,162,343,.472,.475,109,130,.838,37,177,214,59,21,3,52,41,532
31,Paul George\georgpa01,SF,27,OKC,26,26,966,183,448,.408,79,194,.407,104,254,.409,.497,86,104,.827,21,124,145,83,64,14,74,78,531
32,Dennis Schroder\schrode01,PG,24,ATL,27,27,862,209,467,.448,31,98,.316,178,369,.482,.481,82,96,.854,20,58,78,180,30,1,70,54,531
33,Nikola Vucevic\vucevni01,C,27,ORL,30,30,918,223,443,.503,44,127,.346,179,316,.566,.553,36,44,.818,52,232,284,97,32,36,56,74,526
34,Tobias Harris\harrito02,PF,25,DET,29,29,957,193,420,.460,77,177,.435,116,243,.477,.551,54,60,.900,28,130,158,47,19,6,27,55,517
35,Donovan Mitchell\mitchdo01,SG,21,UTA,29,21,875,190,456,.417,68,186,.366,122,270,.452,.491,68,80,.850,16,73,89,102,41,13,72,88,516
36,Tyreke Evans\evansty01,SG,28,MEM,28,9,835,192,401,.479,56,134,.418,136,267,.509,.549,73,94,.777,24,112,136,111,26,12,55,53,513
37,Carmelo Anthony\anthoca01,SF,33,OKC,27,27,902,179,437,.410,54,158,.342,125,279,.448,.471,73,96,.760,22,151,173,41,22,20,40,73,485
38,Evan Fournier\fournev01,SF,25,ORL,26,26,845,174,364,.478,59,142,.415,115,222,.518,.559,70,81,.864,14,70,84,79,28,7,50,62,477
39,Aaron Gordon\gordoaa01,PF,22,ORL,26,26,866,167,341,.490,57,142,.401,110,199,.553,.573,84,113,.743,38,170,208,57,26,22,41,48,475
40,Goran Dragic\dragigo01,PG,31,MIA,28,28,880,172,385,.447,44,115,.383,128,270,.474,.504,82,105,.781,19,95,114,125,25,4,67,59,470
41,Ben Simmons\simmobe01,PG,21,PHI,27,27,993,196,387,.506,0,8,.000,196,379,.517,.506,76,136,.559,54,186,240,211,57,21,107,72,468
42,Eric Gordon\gordoer01,SG,29,HOU,25,13,783,146,358,.408,77,234,.329,69,124,.556,.515,98,117,.838,5,45,50,56,16,9,55,44,467
43,Dwight Howard\howardw01,C,32,CHO,28,28,843,171,309,.553,0,1,.000,171,308,.555,.553,115,223,.516,100,252,352,32,14,38,98,95,457
44,Jonathon Simmons\simmojo02,SG,28,ORL,30,11,852,171,357,.479,30,87,.345,141,270,.522,.521,84,113,.743,27,79,106,63,24,5,69,78,456
45,Blake Griffin\griffbl01,PF,28,LAC,19,19,680,150,353,.425,41,116,.353,109,237,.460,.483,107,137,.781,25,125,150,96,18,6,57,48,448
46,J.J. Redick\redicjj01,SG,33,PHI,26,26,889,152,347,.438,68,177,.384,84,170,.494,.536,71,75,.947,5,65,70,93,16,2,39,61,443
47,Reggie Jackson\jacksre01,PG,27,DET,29,29,797,164,360,.456,39,108,.361,125,252,.496,.510,75,89,.843,22,58,80,148,20,3,72,64,442
48,Will Barton\bartowi01,SG,27,DEN,28,8,881,163,345,.472,58,141,.411,105,204,.515,.557,57,81,.704,25,123,148,100,33,15,51,56,441
49,Avery Bradley\bradlav01,SG,27,DET,28,28,877,164,386,.425,53,128,.414,111,258,.430,.494,58,71,.817,16,52,68,55,35,5,67,59,439
50,Brandon Ingram\ingrabr01,SF,20,LAL,27,27,928,163,360,.453,16,46,.348,147,314,.468,.475,95,141,.674,29,122,151,84,24,20,70,88,437
51,Gary Harris\harriga01,SG,23,DEN,27,27,916,167,347,.481,62,160,.388,105,187,.561,.571,38,48,.792,21,60,81,85,52,9,49,54,434
52,Jamal Murray\murraja01,PG,20,DEN,29,29,799,156,356,.438,47,139,.338,109,217,.502,.504,74,79,.937,33,55,88,71,26,8,58,55,433
53,Kyle Lowry\lowryky01,PG,31,TOR,27,27,893,139,325,.428,79,204,.387,60,121,.496,.549,75,86,.872,19,152,171,195,28,3,67,57,432
54,Jaylen Brown\brownja02,SF,21,BOS,29,29,909,157,333,.471,50,126,.397,107,207,.517,.547,62,103,.602,31,138,169,35,34,10,50,80,426
55,Kyle Kuzma\kuzmaky01,PF,22,LAL,26,11,791,165,336,.491,42,115,.365,123,221,.557,.554,51,66,.773,43,130,173,39,9,6,49,53,423
56,Jayson Tatum\tatumja01,SF,19,BOS,31,31,941,139,278,.500,48,96,.500,91,182,.500,.586,96,116,.828,23,150,173,41,28,24,37,69,422
57,Bojan Bogdanovic\bogdabo02,SF,28,IND,29,29,916,151,315,.479,61,147,.415,90,168,.536,.576,50,58,.862,8,83,91,39,18,1,34,51,413
58,Otto Porter\porteot01,SF,24,WAS,28,28,882,164,328,.500,47,105,.448,117,223,.525,.572,34,42,.810,33,157,190,50,42,15,24,54,409
59,Andre Drummond\drumman01,C,24,DET,29,29,959,156,293,.532,0,2,.000,156,291,.536,.532,94,151,.623,146,294,440,112,44,36,89,97,406
60,Jordan Clarkson\clarkjo01,SG,25,LAL,27,0,611,157,327,.480,35,98,.357,122,229,.533,.534,53,68,.779,23,56,79,81,17,0,50,37,402
61,Al Horford\horfoal01,C,31,BOS,28,28,916,158,295,.536,41,98,.418,117,197,.594,.605,42,52,.808,36,185,221,150,17,28,56,47,399
62,E'Twaun Moore\mooreet01,SG,28,NOP,30,28,978,164,306,.536,57,120,.475,107,186,.575,.629,12,20,.600,26,56,82,62,29,4,36,77,397
63,Zach Randolph\randoza01,PF,36,SAC,26,25,674,168,328,.512,21,59,.356,147,269,.546,.544,39,50,.780,46,137,183,58,24,4,48,51,396
64,Robert Covington\covinro01,PF,27,PHI,26,26,852,135,313,.431,85,207,.411,50,106,.472,.567,38,47,.809,26,139,165,49,44,22,48,83,393
65,Jeremy Lamb\lambje01,SG,25,CHO,27,14,730,140,321,.436,34,98,.347,106,223,.475,.489,76,88,.864,13,114,127,75,20,12,43,50,390
66,Thaddeus Young\youngth01,PF,29,IND,29,29,982,171,346,.494,31,89,.348,140,257,.545,.539,13,24,.542,64,120,184,57,53,14,36,64,386
67,Dion Waiters\waitedi01,SG,26,MIA,26,26,806,145,369,.393,48,156,.308,97,213,.455,.458,41,57,.719,8,56,64,97,20,8,63,56,379
68,Austin Rivers\riverau01,SG,25,LAC,26,24,860,138,341,.405,60,149,.403,78,192,.406,.493,42,65,.646,13,40,53,89,37,6,48,66,378
69,Robin Lopez\lopezro01,C,29,CHI,28,28,851,169,322,.525,2,7,.286,167,315,.530,.528,37,51,.725,79,77,156,59,6,24,53,62,377
70,Tim Hardaway\hardati02,SG,25,NYK,21,21,716,133,317,.420,48,152,.316,85,165,.515,.495,60,75,.800,17,71,88,70,24,5,36,46,374
71,Jusuf Nurkic\nurkiju01,C,23,POR,25,25,697,152,336,.452,0,5,.000,152,331,.459,.452,68,105,.648,46,151,197,52,18,32,76,77,372
72,Taurean Waller-Prince\princta02,SF,23,ATL,29,29,900,142,320,.444,51,120,.425,91,200,.455,.523,37,50,.740,22,130,152,73,31,15,64,60,372
73,Courtney Lee\leeco01,SG,32,NYK,28,28,907,141,293,.481,44,99,.444,97,194,.500,.556,44,47,.936,13,86,99,78,39,3,34,41,370
74,Clint Capela\capelca01,C,23,HOU,27,27,679,160,233,.687,0,1,.000,160,232,.690,.687,49,84,.583,85,212,297,31,20,49,43,73,369
75,Lauri Markkanen\markkla01,PF,20,CHI,25,25,767,130,324,.401,56,167,.335,74,157,.471,.488,52,62,.839,27,175,202,32,13,15,35,43,368
76,Rondae Hollis-Jefferson\holliro01,SF,23,BRK,25,24,693,130,260,.500,6,21,.286,124,239,.519,.512,101,125,.808,36,111,147,46,23,20,37,45,367
77,Justin Holiday\holidju01,SG,28,CHI,27,27,910,124,343,.362,64,188,.340,60,155,.387,.455,55,70,.786,16,107,123,58,34,17,34,55,367
78,Kent Bazemore\bazemke01,SG,28,ATL,29,29,830,120,301,.399,45,119,.378,75,182,.412,.473,76,93,.817,14,119,133,107,53,17,71,64,361
79,J.J. Barea\bareajo01,PG,33,DAL,29,1,657,129,295,.437,55,140,.393,74,155,.477,.531,42,55,.764,7,82,89,157,15,1,59,44,355
80,Wesley Matthews\matthwe02,SG,31,DAL,29,28,997,126,315,.400,72,180,.400,54,135,.400,.514,31,39,.795,9,79,88,82,29,4,43,64,355
81,John Wall\walljo01,PG,27,WAS,18,18,608,122,287,.425,21,69,.304,101,218,.463,.462,88,123,.715,6,55,61,156,21,21,55,39,353
82,Brook Lopez\lopezbr01,C,29,LAL,27,27,617,132,299,.441,33,109,.303,99,190,.521,.497,55,71,.775,35,83,118,47,11,43,46,80,352
83,Rodney Hood\hoodro01,SG,25,UTA,20,9,565,122,291,.419,58,138,.420,64,153,.418,.519,49,56,.875,6,48,54,36,14,5,37,41,351
84,Derrick Favors\favorde01,PF,26,UTA,29,29,792,145,263,.551,5,19,.263,140,244,.574,.561,55,75,.733,66,124,190,46,21,28,41,64,350
85,Eric Bledsoe\bledser01,PG,28,TOT,20,20,620,119,275,.433,30,96,.313,89,179,.497,.487,75,101,.743,16,56,72,84,40,13,59,42,343
86,Ricky Rubio\rubiori01,PG,27,UTA,28,28,811,114,282,.404,30,105,.286,84,177,.475,.457,84,96,.875,14,91,105,137,45,4,87,79,342
87,Steven Adams\adamsst01,C,24,OKC,25,25,814,146,230,.635,0,1,.000,146,229,.638,.635,50,77,.649,124,96,220,21,30,24,42,70,342
88,Marco Belinelli\belinma01,SG,31,ATL,29,0,717,113,277,.408,56,147,.381,57,130,.438,.509,60,63,.952,5,61,66,66,28,1,32,21,342
89,Serge Ibaka\ibakase01,PF,28,TOR,25,25,694,136,266,.511,45,112,.402,91,154,.591,.596,25,37,.676,20,127,147,17,8,35,27,76,342
90,Spencer Dinwiddie\dinwisp01,PG,24,BRK,27,17,720,114,287,.397,53,149,.356,61,138,.442,.490,59,79,.747,18,74,92,177,20,11,38,68,340
91,Kentavious Caldwell-Pope\caldwke01,SG,24,LAL,24,24,829,120,288,.417,53,147,.361,67,141,.475,.509,47,65,.723,21,97,118,55,42,7,40,45,340
92,Rudy Gay\gayru01,SF,31,SAS,27,4,631,128,261,.490,19,57,.333,109,204,.534,.527,64,81,.790,40,113,153,47,25,18,46,52,339
93,Jeff Teague\teaguje01,PG,29,MIN,25,25,853,121,275,.440,38,93,.409,83,182,.456,.509,59,72,.819,8,61,69,178,39,8,77,63,339
94,Nikola Jokic\jokicni01,C,22,DEN,22,21,640,129,254,.508,29,71,.408,100,183,.546,.565,51,59,.864,58,176,234,100,29,13,47,52,338
95,Julius Randle\randlju01,C,23,LAL,27,0,609,130,234,.556,5,24,.208,125,210,.595,.566,71,108,.657,33,133,166,51,12,23,61,94,336
96,Darren Collison\collida01,PG,30,IND,28,28,863,123,263,.468,35,89,.393,88,174,.506,.534,55,63,.873,19,71,90,171,34,6,44,59,336
97,Enes Kanter\kanteen01,C,25,NYK,25,25,647,143,238,.601,0,1,.000,143,237,.603,.601,49,53,.925,89,168,257,35,15,10,43,63,335
98,DeMarre Carroll\carrode01,SF,31,BRK,25,25,740,108,262,.412,47,128,.367,61,134,.455,.502,69,95,.726,40,135,175,43,23,11,38,58,332
99,Dennis Smith\smithde03,PG,20,DAL,23,23,647,132,334,.395,34,111,.306,98,223,.439,.446,33,50,.660,20,73,93,93,19,7,69,45,331
100,Malcolm Brogdon\brogdma01,PG,25,MIL,26,10,785,130,283,.459,36,96,.375,94,187,.503,.523,33,39,.846,8,64,72,93,24,4,36,63,329
101,Dirk Nowitzki\nowitdi01,C,39,DAL,29,29,728,123,277,.444,44,104,.423,79,173,.457,.523,38,42,.905,12,153,165,49,16,8,24,52,328
102,Kelly Oubre\oubreke01,SF,22,WAS,29,6,801,108,266,.406,42,114,.368,66,152,.434,.485,68,84,.810,22,131,153,29,28,15,31,81,326
103,Mike James\jamesmi02,PG,27,PHO,30,10,648,118,302,.391,25,93,.269,93,209,.445,.432,64,84,.762,12,74,86,116,27,7,49,44,325
104,Buddy Hield\hieldbu01,SG,24,SAC,26,7,600,125,275,.455,52,113,.460,73,162,.451,.549,22,25,.880,17,80,97,40,28,4,41,46,324
105,Domantas Sabonis\sabondo01,C,21,IND,27,8,650,122,223,.547,5,12,.417,117,211,.555,.558,73,99,.737,72,154,226,54,8,7,55,78,322
106,Dario Saric\saricda01,PF,23,PHI,27,22,808,123,294,.418,44,132,.333,79,162,.488,.493,32,40,.800,56,130,186,60,14,9,45,57,322
107,Taj Gibson\gibsota01,PF,32,MIN,29,29,961,128,239,.536,5,20,.250,123,219,.562,.546,60,74,.811,81,161,242,44,26,19,39,80,321
108,Myles Turner\turnemy01,C,21,IND,22,21,666,124,252,.492,21,59,.356,103,193,.534,.534,52,67,.776,26,133,159,37,7,53,30,62,321
109,Dwyane Wade\wadedw01,SG,36,CLE,27,3,640,120,261,.460,12,33,.364,108,228,.474,.483,58,83,.699,19,77,96,108,24,22,54,53,310
110,Caris LeVert\leverca01,SF,23,BRK,28,9,740,113,271,.417,30,100,.300,83,171,.485,.472,54,77,.701,16,85,101,106,37,11,64,68,310
111,Kris Dunn\dunnkr01,PG,23,CHI,24,15,676,131,302,.434,20,55,.364,111,247,.449,.467,28,45,.622,17,97,114,125,48,7,70,82,310
112,Kyle Korver\korveky01,SG,36,CLE,29,0,652,101,211,.479,75,169,.444,26,42,.619,.656,31,36,.861,3,56,59,29,13,12,21,50,308
113,Jeff Green\greenje02,PF,31,CLE,29,0,635,113,225,.502,15,51,.294,98,174,.563,.536,66,77,.857,26,78,104,42,20,7,29,60,307
114,Joe Ingles\inglejo01,SF,30,UTA,29,29,874,107,240,.446,77,166,.464,30,74,.405,.606,15,18,.833,7,113,120,116,32,5,52,60,306
115,Ryan Anderson\anderry01,PF,29,HOU,26,25,745,106,230,.461,70,170,.412,36,60,.600,.613,22,29,.759,38,103,141,20,10,9,24,49,304
116,James Johnson\johnsja01,PF,30,MIA,27,10,764,115,232,.496,23,69,.333,92,163,.564,.545,49,70,.700,23,119,142,115,28,22,67,81,302
117,Pau Gasol\gasolpa01,C,37,SAS,28,28,698,111,232,.478,23,56,.411,88,176,.500,.528,53,65,.815,39,177,216,82,10,34,39,43,298
118,DeAndre Jordan\jordade01,C,29,LAC,27,27,883,126,192,.656,0,0,,126,192,.656,.656,43,76,.566,131,265,396,31,16,31,51,77,295
119,Alec Burks\burksal01,SG,26,UTA,28,0,559,103,232,.444,30,77,.390,73,155,.471,.509,57,65,.877,8,86,94,34,25,7,30,41,293
120,Trevor Ariza\arizatr01,SF,32,HOU,25,25,864,99,229,.432,66,171,.386,33,58,.569,.576,25,27,.926,13,98,111,46,41,5,22,46,289
121,Tyler Johnson\johnsty01,PG,25,MIA,26,0,712,98,235,.417,46,119,.387,52,116,.448,.515,45,49,.918,10,72,82,50,15,21,33,54,287
122,Allen Crabbe\crabbal01,SG,25,BRK,24,17,670,96,247,.389,59,160,.369,37,87,.425,.508,36,44,.818,11,84,95,35,15,6,27,43,287
123,Josh Richardson\richajo01,SF,24,MIA,28,28,910,108,258,.419,43,132,.326,65,126,.516,.502,27,34,.794,18,69,87,53,33,20,57,84,286
124,Patty Mills\millspa02,PG,29,SAS,29,12,733,98,241,.407,54,142,.380,44,99,.444,.519,31,36,.861,10,56,66,99,22,6,41,40,281
125,Emmanuel Mudiay\mudiaem01,PG,21,DEN,29,0,611,96,244,.393,32,81,.395,64,163,.393,.459,54,68,.794,13,62,75,94,15,3,62,37,278
126,Yogi Ferrell\ferreyo01,SG,24,DAL,29,12,817,98,230,.426,41,108,.380,57,122,.467,.515,41,51,.804,8,76,84,62,22,3,37,60,278
127,Terry Rozier\roziete01,PG,23,BOS,31,0,720,97,261,.372,48,136,.353,49,125,.392,.464,35,44,.795,21,115,136,64,30,1,21,42,277
128,De'Aaron Fox\foxde01,PG,20,SAC,28,15,718,110,272,.404,11,38,.289,99,234,.423,.425,40,58,.690,13,67,80,107,25,7,64,62,271
129,Josh Jackson\jacksjo02,SF,20,PHO,30,8,666,100,267,.375,17,75,.227,83,192,.432,.406,51,91,.560,26,79,105,33,33,6,59,86,268
130,Marcin Gortat\gortama01,C,33,WAS,29,29,825,111,208,.534,0,0,,111,208,.534,.534,44,67,.657,62,184,246,62,20,20,40,61,266
131,Marcus Smart\smartma01,SG,23,BOS,29,6,885,87,274,.318,35,125,.280,52,149,.349,.381,55,76,.724,22,85,107,152,35,14,72,75,264
132,Marvin Williams\willima02,PF,31,CHO,28,28,749,91,196,.464,45,103,.437,46,93,.495,.579,35,41,.854,27,98,125,32,20,11,20,43,262
133,Wayne Ellington\ellinwa01,SG,30,MIA,28,0,585,85,194,.438,75,173,.434,10,21,.476,.631,17,18,.944,7,50,57,26,19,2,11,23,262
134,Kelly Olynyk\olynyke01,PF,26,MIA,28,6,589,92,180,.511,32,76,.421,60,104,.577,.600,43,56,.768,28,121,149,53,19,13,58,89,259
135,Frank Kaminsky\kaminfr01,PF,24,CHO,25,0,567,96,230,.417,28,84,.333,68,146,.466,.478,39,51,.765,12,83,95,36,9,5,19,31,259
136,John Collins\collijo01,PF,20,ATL,23,4,528,111,186,.597,0,1,.000,111,185,.600,.597,37,50,.740,69,94,163,22,17,23,32,81,259
137,Jamal Crawford\crawfja01,SG,37,MIN,29,0,512,90,227,.396,34,99,.343,56,128,.438,.471,45,48,.938,6,26,32,61,15,2,33,32,259
138,Willie Cauley-Stein\caulewi01,C,24,SAC,25,16,614,105,216,.486,1,6,.167,104,210,.495,.488,45,66,.682,42,102,144,54,18,25,36,54,256
139,Jonas Valanciunas\valanjo01,C,25,TOR,23,23,484,100,174,.575,4,9,.444,96,165,.582,.586,52,60,.867,46,128,174,13,8,13,34,61,256
140,Joe Harris\harrijo01,SG,26,BRK,26,4,626,92,207,.444,52,142,.366,40,65,.615,.570,19,27,.704,11,62,73,32,15,6,25,57,255
141,Jae Crowder\crowdja01,SF,27,CLE,29,26,748,83,213,.390,36,115,.313,47,98,.480,.474,51,57,.895,22,65,87,31,19,5,28,65,253
142,Denzel Valentine\valende01,SG,24,CHI,28,17,801,96,256,.375,53,137,.387,43,119,.361,.479,8,11,.727,21,124,145,80,21,3,27,57,253
143,Draymond Green\greendr01,PF,27,GSW,25,25,805,87,193,.451,30,91,.330,57,102,.559,.528,48,63,.762,26,155,181,183,39,36,68,70,252
144,Ish Smith\smithis01,PG,29,DET,29,0,574,114,249,.458,4,20,.200,110,229,.480,.466,20,31,.645,9,54,63,111,13,6,32,44,252
145,D'Angelo Russell\russeda01,PG,21,BRK,12,12,333,95,205,.463,18,61,.295,77,144,.535,.507,43,63,.683,9,47,56,68,12,2,48,30,251
146,Bobby Portis\portibo01,PF,22,CHI,19,0,415,96,196,.490,23,59,.390,73,137,.533,.548,31,40,.775,34,95,129,30,6,5,22,21,246
147,Paul Millsap\millspa01,PF,32,DEN,16,16,475,90,202,.446,20,58,.345,70,144,.486,.495,45,65,.692,24,75,99,48,17,20,33,39,245
148,Lonzo Ball\balllo01,PG,20,LAL,27,27,899,96,289,.332,35,132,.265,61,157,.389,.393,18,37,.486,37,150,187,194,38,25,72,59,245
149,Bogdan Bogdanovic\bogdabo01,SG,25,SAC,25,11,616,92,209,.440,30,87,.345,62,122,.508,.512,29,35,.829,8,52,60,56,28,8,40,44,243
150,Danny Green\greenda02,SG,30,SAS,27,27,753,93,231,.403,46,127,.362,47,104,.452,.502,11,15,.733,14,91,105,52,29,32,41,35,243
151,Tyler Ulis\ulisty01,PG,22,PHO,29,17,694,91,226,.403,12,47,.255,79,179,.441,.429,47,57,.825,6,49,55,123,28,2,56,44,241
152,Jerian Grant\grantje02,PG,25,CHI,28,14,659,83,193,.430,23,68,.338,60,125,.480,.490,51,72,.708,15,57,72,140,25,2,39,54,240
153,Wilson Chandler\chandwi01,SF,30,DEN,25,25,749,86,207,.415,27,83,.325,59,124,.476,.481,41,48,.854,35,81,116,58,12,8,36,49,240
154,George Hill\hillge01,PG,31,SAC,25,25,644,87,188,.463,31,66,.470,56,122,.459,.545,35,45,.778,11,65,76,62,23,6,33,38,240
155,Doug McDermott\mcderdo01,SF,26,NYK,28,0,676,96,195,.492,31,77,.403,65,118,.551,.572,16,21,.762,21,62,83,31,5,9,19,48,239
156,J.R. Smith\smithjr01,SG,32,CLE,29,26,889,86,219,.393,57,156,.365,29,63,.460,.523,9,15,.600,12,74,86,69,29,2,31,68,238
157,Lance Stephenson\stephla01,SG,27,IND,29,1,642,94,215,.437,20,65,.308,74,150,.493,.484,29,47,.617,25,125,150,80,15,5,42,54,237
158,Darius Miller\milleda01,SF,27,NOP,30,2,614,79,166,.476,58,127,.457,21,39,.538,.651,16,20,.800,5,43,48,36,10,5,16,48,232
159,Mike Scott\scottmi01,PF,29,WAS,26,1,481,95,166,.572,22,52,.423,73,114,.640,.639,19,28,.679,17,78,95,17,11,6,31,49,231
160,C.J. Miles\milescj01,SF,30,TOR,23,0,425,76,190,.400,53,141,.376,23,49,.469,.539,23,26,.885,5,37,42,16,18,9,13,43,228
161,Trevor Booker\booketr01,PF,30,TOT,22,5,472,95,177,.537,3,14,.214,92,163,.564,.545,34,54,.630,51,93,144,45,11,8,34,47,227
162,Troy Daniels\danietr01,SG,26,PHO,30,0,499,78,174,.448,60,138,.435,18,36,.500,.621,10,11,.909,3,32,35,15,7,1,17,40,226
163,Alex Len\lenal01,C,24,PHO,25,2,546,77,147,.524,0,0,,77,147,.524,.524,71,93,.763,76,144,220,24,7,28,33,60,225
164,Elfrid Payton\paytoel01,PG,23,ORL,21,21,590,95,198,.480,14,39,.359,81,159,.509,.515,21,41,.512,22,55,77,130,29,7,52,46,225
165,Hassan Whiteside\whiteha01,C,28,MIA,15,15,402,93,160,.581,2,2,1.000,91,158,.576,.588,36,52,.692,42,149,191,6,14,24,23,32,224
166,Michael Kidd-Gilchrist\kiddgmi01,SF,24,CHO,22,22,589,97,186,.522,0,1,.000,97,185,.524,.522,29,42,.690,24,80,104,21,17,16,13,48,223
167,Chris Paul\paulch01,PG,32,HOU,13,13,401,78,162,.481,33,76,.434,45,86,.523,.583,33,37,.892,8,58,66,123,32,5,27,32,222
168,Dewayne Dedmon\dedmode01,C,28,ATL,20,20,487,92,153,.601,14,29,.483,78,124,.629,.647,23,32,.719,39,116,155,28,8,17,35,60,221
169,Dillon Brooks\brookdi01,SF,22,MEM,29,21,807,86,187,.460,20,64,.313,66,123,.537,.513,28,36,.778,18,77,95,36,25,11,40,98,220
170,Evan Turner\turneev01,SF,29,POR,28,5,731,83,208,.399,8,42,.190,75,166,.452,.418,42,48,.875,10,97,107,64,20,11,47,63,216
171,Cory Joseph\josepco01,PG,26,IND,29,1,712,78,195,.400,32,73,.438,46,122,.377,.482,28,31,.903,6,67,73,85,30,6,30,38,216
172,Chandler Parsons\parsoch01,SF,29,MEM,23,6,485,82,164,.500,37,84,.440,45,80,.563,.613,15,25,.600,10,57,67,47,13,7,26,40,216
173,Mario Chalmers\chalmma01,PG,31,MEM,28,7,652,73,200,.365,20,82,.244,53,118,.449,.415,48,61,.787,4,75,79,94,37,4,48,78,214
174,Jerami Grant\grantje01,PF,23,OKC,27,1,575,76,153,.497,11,41,.268,65,112,.580,.533,48,69,.696,33,69,102,23,18,24,24,51,211
175,Thabo Sefolosha\sefolth01,SF,33,UTA,27,1,562,79,155,.510,24,59,.407,55,96,.573,.587,28,33,.848,16,96,112,24,38,6,18,36,210
176,Rudy Gobert\goberru01,C,25,UTA,18,18,539,76,127,.598,0,0,,76,127,.598,.598,56,82,.683,47,125,172,21,10,41,35,41,208
177,Mike Conley\conlemi01,PG,30,MEM,12,12,373,64,168,.381,24,77,.312,40,91,.440,.452,53,66,.803,0,27,27,49,12,3,18,24,205
178,Markieff Morris\morrima02,PF,28,WAS,21,21,485,83,185,.449,21,58,.362,62,127,.488,.505,18,22,.818,20,63,83,27,14,13,34,66,205
179,Kyle Anderson\anderky01,SF,24,SAS,23,23,631,80,156,.513,4,11,.364,76,145,.524,.526,40,53,.755,31,106,137,70,27,19,30,37,204
180,Devin Harris\harride01,PG,34,DAL,23,1,439,64,157,.408,21,62,.339,43,95,.453,.475,52,64,.813,8,37,45,50,24,4,26,64,201
181,Jodie Meeks\meeksjo01,SG,30,WAS,29,0,488,61,170,.359,26,87,.299,35,83,.422,.435,51,57,.895,7,36,43,18,17,1,16,30,199
182,John Henson\hensojo01,C,27,MIL,26,19,610,86,147,.585,0,2,.000,86,145,.593,.585,26,55,.473,47,126,173,34,13,42,33,75,198
183,Jerryd Bayless\bayleje01,SG,29,PHI,22,8,577,67,160,.419,35,90,.389,32,70,.457,.528,29,36,.806,7,45,52,38,14,3,29,52,198
184,Terrence Ross\rosste01,SG,26,ORL,22,20,576,72,177,.407,28,85,.329,44,92,.478,.486,26,35,.743,10,60,70,35,27,10,25,44,198
185,Garrett Temple\templga01,SG,31,SAC,27,21,658,69,188,.367,38,101,.376,31,87,.356,.468,22,29,.759,7,51,58,41,27,14,28,57,198
186,Bryn Forbes\forbebr01,SG,24,SAS,29,2,537,76,175,.434,37,88,.420,39,87,.448,.540,9,20,.450,7,33,40,28,9,2,14,37,198
187,Tony Snell\snellto01,SG,26,MIL,23,21,729,73,139,.525,39,82,.476,34,57,.596,.665,12,16,.750,4,41,45,38,15,8,12,37,197
188,D.J. Augustin\augusdj01,PG,30,ORL,23,6,471,61,133,.459,28,64,.438,33,69,.478,.564,46,54,.852,5,36,41,79,19,0,37,35,196
189,Marcus Morris\morrima03,SF,28,BOS,16,9,387,68,165,.412,20,61,.328,48,104,.462,.473,38,45,.844,7,81,88,25,10,4,17,28,194
190,Skal Labissiere\labissk01,PF,21,SAC,26,12,434,78,177,.441,4,9,.444,74,168,.440,.452,34,43,.791,35,69,104,19,11,16,29,54,194
191,Mason Plumlee\plumlma01,C,27,DEN,29,7,556,81,142,.570,0,1,.000,81,141,.574,.570,31,78,.397,44,108,152,51,19,29,42,62,193
192,Manu Ginobili\ginobma01,SG,40,SAS,24,0,496,66,165,.400,21,73,.288,45,92,.489,.464,40,48,.833,7,44,51,57,14,5,44,49,193
193,Michael Beasley\beaslmi01,PF,29,NYK,22,4,343,84,165,.509,3,15,.200,81,150,.540,.518,21,33,.636,23,56,79,20,4,7,43,38,192
194,Norman Powell\powelno01,SG,24,TOR,23,12,466,71,167,.425,23,74,.311,48,93,.516,.494,26,31,.839,5,42,47,41,22,7,33,49,191
195,Luke Babbitt\babbilu01,SF,28,ATL,26,9,490,68,141,.482,41,90,.456,27,51,.529,.628,14,19,.737,4,66,70,21,7,4,14,41,191
196,Marquese Chriss\chrisma01,PF,20,PHO,30,24,604,68,169,.402,20,66,.303,48,103,.466,.462,34,48,.708,27,112,139,35,17,31,29,86,190
197,Jakob Poeltl\poeltja01,C,22,TOR,27,0,448,85,124,.685,1,2,.500,84,122,.689,.690,19,38,.500,55,63,118,10,10,28,21,63,190
198,James Ennis\ennisja01,SF,27,MEM,27,14,669,67,133,.504,18,54,.333,49,79,.620,.571,36,41,.878,32,64,96,29,18,5,23,52,188
199,Wesley Johnson\johnswe01,SF,30,LAC,27,18,673,71,174,.408,24,83,.289,47,91,.516,.477,22,31,.710,12,82,94,29,29,30,28,64,188
200,David West\westda01,C,37,GSW,27,0,340,83,124,.669,3,6,.500,80,118,.678,.681,18,27,.667,20,70,90,44,19,32,29,38,187
201,Aron Baynes\baynear01,C,31,BOS,31,20,558,78,155,.503,0,4,.000,78,151,.517,.503,30,43,.698,55,106,161,27,10,20,34,66,186
202,Raymond Felton\feltora01,PG,33,OKC,28,0,470,76,180,.422,22,61,.361,54,119,.454,.483,11,16,.688,7,41,48,71,18,3,20,31,185
203,Dejounte Murray\murrade01,PG,21,SAS,29,9,520,71,173,.410,3,10,.300,68,163,.417,.419,39,53,.736,34,93,127,70,22,6,45,49,184
204,Stanley Johnson\johnsst04,SF,21,DET,26,22,721,66,185,.357,25,89,.281,41,96,.427,.424,27,36,.750,10,82,92,37,31,5,23,64,184
205,Trey Lyles\lylestr01,PF,22,DEN,24,1,373,65,127,.512,26,53,.491,39,74,.527,.614,27,38,.711,19,68,87,20,10,9,17,24,183
206,Nick Young\youngni01,SG,32,GSW,27,0,353,63,138,.457,41,99,.414,22,39,.564,.605,16,24,.667,4,30,34,13,13,2,14,24,183
207,Langston Galloway\gallola01,SG,26,DET,27,0,382,63,150,.420,44,106,.415,19,44,.432,.567,13,15,.867,5,43,48,20,12,3,8,19,183
208,Justise Winslow\winslju01,SF,21,MIA,27,15,611,72,169,.426,16,41,.390,56,128,.438,.473,17,26,.654,26,119,145,51,18,10,28,47,177
209,OG Anunoby\anunoog01,SF,20,TOR,27,15,548,65,133,.489,31,73,.425,34,60,.567,.605,16,24,.667,18,36,54,23,23,1,15,55,177
210,Kyle O'Quinn\oquinky01,C,27,NYK,28,3,457,70,125,.560,0,4,.000,70,121,.579,.560,35,44,.795,48,122,170,57,12,29,44,76,175
211,Anthony Tolliver\tollian01,PF,32,DET,26,1,484,56,134,.418,40,106,.377,16,28,.571,.567,23,31,.742,15,55,70,27,11,7,18,45,175
212,Dwight Powell\poweldw01,C,26,DAL,28,0,502,70,137,.511,9,38,.237,61,99,.616,.544,25,40,.625,44,103,147,29,20,11,18,55,174
213,Pat Connaughton\connapa01,SG,25,POR,28,5,554,63,143,.441,33,84,.393,30,59,.508,.556,14,16,.875,8,54,62,32,4,7,17,38,173
214,Greg Monroe\monrogr01,C,27,TOT,17,9,354,74,128,.578,0,0,,74,128,.578,.578,23,33,.697,34,87,121,32,10,5,27,31,171
215,Gorgui Dieng\dienggo01,C,28,MIN,26,0,459,67,133,.504,5,23,.217,62,110,.564,.523,31,41,.756,40,86,126,34,21,5,27,54,170
216,Tyler Zeller\zellety01,C,28,BRK,20,12,377,71,117,.607,3,11,.273,68,106,.642,.620,25,40,.625,30,66,96,14,7,11,24,37,170
217,JaMychal Green\greenja01,PF,27,MEM,17,17,480,67,139,.482,16,41,.390,51,98,.520,.540,20,30,.667,30,79,109,22,8,3,27,45,170
218,Fred VanVleet\vanvlfr01,PG,23,TOR,27,0,466,63,160,.394,22,67,.328,41,93,.441,.463,22,26,.846,5,36,41,77,23,6,24,44,170
219,Ersan Ilyasova\ilyaser01,PF,30,ATL,18,12,416,65,143,.455,25,65,.385,40,78,.513,.542,15,21,.714,26,56,82,22,21,6,12,38,170
220,Pascal Siakam\siakapa01,PF,23,TOR,26,4,524,78,157,.497,9,54,.167,69,103,.670,.525,5,20,.250,27,90,117,44,24,11,21,47,170
221,Frank Mason\masonfr01,PG,23,SAC,21,0,398,56,147,.381,14,33,.424,42,114,.368,.429,41,53,.774,10,34,44,68,9,1,33,25,167
222,P.J. Tucker\tuckepj01,SF,32,HOU,27,2,721,56,134,.418,35,95,.368,21,39,.538,.549,20,25,.800,29,125,154,24,31,7,30,74,167
223,Kenneth Faried\farieke01,PF,28,DEN,25,7,399,67,121,.554,0,1,.000,67,120,.558,.554,32,45,.711,56,75,131,17,8,12,20,42,166
224,Dante Cunningham\cunnida01,SF,30,NOP,29,19,672,63,146,.432,25,77,.325,38,69,.551,.517,15,26,.577,29,91,120,19,16,9,8,51,166
225,Timothe Luwawu-Cabarrot\luwawti01,SF,22,PHI,26,1,425,57,148,.385,25,82,.305,32,66,.485,.470,26,35,.743,12,32,44,25,8,1,23,56,165
226,Jarrett Jack\jackja01,PG,34,NYK,26,25,676,70,165,.424,10,31,.323,60,134,.448,.455,15,21,.714,8,79,87,156,12,1,46,36,165
227,Luc Mbah a Moute\mbahalu01,PF,31,HOU,24,3,607,60,131,.458,25,67,.373,35,64,.547,.553,18,27,.667,13,68,81,23,30,12,30,44,163
228,Shabazz Napier\napiesh01,PG,26,POR,22,0,369,57,118,.483,18,38,.474,39,80,.488,.559,30,35,.857,5,36,41,32,27,2,17,22,162
229,Jonas Jerebko\jerebjo01,PF,30,UTA,24,10,414,61,119,.513,26,57,.456,35,62,.565,.622,13,15,.867,21,70,91,19,11,4,10,48,161
230,Omri Casspi\casspom01,SF,29,GSW,25,6,383,62,103,.602,9,15,.600,53,88,.602,.646,27,38,.711,12,96,108,27,7,14,15,38,160
231,Malik Monk\monkma01,SG,19,CHO,25,0,392,57,170,.335,32,95,.337,25,75,.333,.429,12,17,.706,2,30,32,39,7,3,19,28,158
232,Tyson Chandler\chandty01,C,35,PHO,21,21,548,63,96,.656,0,0,,63,96,.656,.656,30,47,.638,62,141,203,21,9,15,24,56,156
233,Andrew Harrison\harrian01,PG,23,MEM,23,13,433,51,123,.415,17,48,.354,34,75,.453,.484,37,44,.841,10,35,45,53,17,8,28,41,156
234,Marreese Speights\speigma01,C,30,ORL,23,0,272,55,149,.369,36,99,.364,19,50,.380,.490,10,16,.625,8,40,48,14,4,7,14,42,156
235,Al-Farouq Aminu\aminual01,PF,27,POR,15,13,450,54,115,.470,34,69,.493,20,46,.435,.617,12,14,.857,20,89,109,17,9,13,17,31,154
236,Jameer Nelson\nelsoja01,PG,35,NOP,26,0,651,57,136,.419,27,72,.375,30,64,.469,.518,12,15,.800,7,59,66,116,21,3,40,48,153
237,Andre Iguodala\iguodan01,SF,34,GSW,25,1,666,57,126,.452,13,48,.271,44,78,.564,.504,24,38,.632,24,76,100,81,17,15,25,31,151
238,Dragan Bender\bendedr01,PF,20,PHO,30,1,608,52,141,.369,33,94,.351,19,47,.404,.486,12,16,.750,13,88,101,28,8,20,28,43,149
239,T.J. McConnell\mccontj01,PG,25,PHI,23,1,547,64,124,.516,9,16,.563,55,108,.509,.552,12,14,.857,16,65,81,115,27,4,46,48,149
240,Danilo Gallinari\gallida01,SF,29,LAC,11,11,349,48,139,.345,16,62,.258,32,77,.416,.403,35,36,.972,2,46,48,29,8,2,16,16,147
241,Frank Ntilikina\ntilila01,PG,19,NYK,25,0,509,55,155,.355,16,50,.320,39,105,.371,.406,21,29,.724,12,42,54,86,35,3,49,64,147
242,Luke Kennard\kennalu01,SG,21,DET,24,1,397,56,135,.415,22,59,.373,34,76,.447,.496,13,17,.765,6,34,40,30,15,3,23,21,147
243,Nene Hilario\hilarne01,C,35,HOU,20,0,285,55,86,.640,0,2,.000,55,84,.655,.640,34,46,.739,16,47,63,20,11,6,21,53,144
244,Kosta Koufos\koufoko01,C,28,SAC,28,1,512,61,113,.540,0,0,,61,113,.540,.540,19,40,.475,49,116,165,33,14,15,18,48,141
245,Larry Nance\nancela02,PF,25,LAL,16,16,376,61,107,.570,0,2,.000,61,105,.581,.570,19,28,.679,44,71,115,19,26,8,18,52,141
246,Cody Zeller\zelleco01,C,25,CHO,19,0,378,47,95,.495,1,1,1.000,46,94,.489,.500,42,58,.724,46,59,105,16,9,21,21,52,137
247,Alex Abrines\abrinal01,SG,24,OKC,26,4,466,46,118,.390,30,81,.370,16,37,.432,.517,15,19,.789,11,34,45,11,16,2,15,54,137
248,Nicolas Batum\batumni01,SG,29,CHO,14,14,424,50,135,.370,12,54,.222,38,81,.469,.415,23,28,.821,9,55,64,66,14,4,29,16,135
249,Patrick Beverley\beverpa01,SG,29,LAC,11,11,334,48,119,.403,24,60,.400,24,59,.407,.504,14,17,.824,16,29,45,32,19,5,25,34,134
250,David Nwaba\nwabada01,SG,25,CHI,16,3,383,49,87,.563,3,8,.375,46,79,.582,.580,31,48,.646,12,78,90,24,13,12,11,32,132
251,Ed Davis\davised01,PF,28,POR,28,0,482,51,101,.505,0,0,,51,101,.505,.505,29,43,.674,67,122,189,9,14,19,27,61,131
252,Shaun Livingston\livinsh01,PG,32,GSW,26,4,418,58,116,.500,0,2,.000,58,114,.509,.500,15,20,.750,16,32,48,50,10,8,22,40,131
253,Nemanja Bjelica\bjeline01,PF,29,MIN,18,0,275,48,83,.578,21,41,.512,27,42,.643,.705,11,12,.917,8,43,51,13,10,4,13,30,128
254,Bismack Biyombo\biyombi01,C,25,ORL,30,0,458,47,96,.490,0,1,.000,47,95,.495,.490,33,56,.589,40,97,137,10,5,32,30,56,127
255,Montrezl Harrell\harremo01,C,24,LAC,21,2,239,52,81,.642,0,0,,52,81,.642,.642,23,32,.719,26,41,67,14,7,9,10,24,127
256,Daniel Theis\theisda01,C,25,BOS,29,2,353,49,94,.521,3,19,.158,46,75,.613,.537,25,31,.806,37,73,110,15,13,20,32,65,126
257,Zaza Pachulia\pachuza01,C,33,GSW,25,25,359,51,91,.560,0,0,,51,91,.560,.560,23,29,.793,28,92,120,39,19,6,32,43,125
258,Maxi Kleber\klebima01,PF,26,DAL,23,14,415,50,93,.538,11,35,.314,39,58,.672,.597,14,21,.667,25,52,77,11,5,11,8,40,125
259,Ben McLemore\mclembe01,SG,24,MEM,18,5,340,49,116,.422,15,47,.319,34,69,.493,.487,12,15,.800,6,36,42,17,10,5,19,45,125
260,Isaiah Taylor\taylois01,PG,23,ATL,22,0,347,44,102,.431,8,25,.320,36,77,.468,.471,28,41,.683,6,24,30,46,13,7,25,28,124
261,Maurice Harkless\harklma01,SF,24,POR,25,19,560,48,117,.410,10,39,.256,38,78,.487,.453,18,24,.750,19,58,77,17,19,21,19,41,124
262,Andre Roberson\roberan03,SF,26,OKC,26,26,696,56,106,.528,7,33,.212,49,73,.671,.561,5,13,.385,47,69,116,28,25,25,25,55,124
263,Rajon Rondo\rondora01,PG,31,NOP,16,15,413,54,109,.495,14,37,.378,40,72,.556,.560,2,2,1.000,8,58,66,126,16,5,35,29,124
264,Bam Adebayo\adebaba01,C,20,MIA,19,6,323,44,68,.647,0,0,,44,68,.647,.647,30,40,.750,28,50,78,9,14,12,16,38,118
265,Thon Maker\makerth01,C,20,MIL,27,8,509,43,108,.398,11,39,.282,32,69,.464,.449,20,31,.645,29,67,96,20,17,21,20,72,117
266,Channing Frye\fryech01,C,34,CLE,27,0,344,47,95,.495,15,48,.313,32,47,.681,.574,7,7,1.000,6,59,65,18,9,6,10,40,116
267,Tyus Jones\jonesty01,PG,21,MIN,29,3,496,40,90,.444,14,35,.400,26,55,.473,.522,21,26,.808,6,47,53,77,31,2,18,33,115
268,Justin Jackson\jacksju01,SF,22,SAC,19,5,356,46,119,.387,17,53,.321,29,66,.439,.458,6,10,.600,9,24,33,11,3,3,13,18,115
269,Quincy Acy\acyqu01,PF,27,BRK,23,0,399,31,104,.298,25,82,.305,6,22,.273,.418,27,32,.844,14,74,88,14,7,4,25,46,114
270,Delon Wright\wrighde01,PG,25,TOR,15,0,307,37,73,.507,8,30,.267,29,43,.674,.562,31,33,.939,6,28,34,39,14,5,25,20,113
271,Tomas Satoransky\satorto01,SG,26,WAS,20,0,339,40,80,.500,10,24,.417,30,56,.536,.563,22,32,.688,15,34,49,57,8,0,12,32,112
272,Ian Clark\clarkia01,SG,26,NOP,24,1,361,42,113,.372,19,59,.322,23,54,.426,.456,9,13,.692,2,31,33,32,9,2,16,28,112
273,Willie Reed\reedwi02,C,27,LAC,22,0,222,44,64,.688,1,1,1.000,43,63,.683,.695,22,37,.595,18,45,63,5,4,8,10,36,111
274,Sindarius Thornwell\thornsi01,SG,23,LAC,27,8,438,40,94,.426,12,30,.400,28,64,.438,.489,19,29,.655,10,30,40,18,16,9,21,60,111
275,Amir Johnson\johnsam01,C,30,PHI,26,4,397,45,91,.495,2,13,.154,43,78,.551,.505,17,31,.548,49,83,132,35,18,19,26,74,109
276,Lance Thomas\thomala01,PF,29,NYK,25,5,428,35,90,.389,12,35,.343,23,55,.418,.456,26,32,.813,18,45,63,10,8,0,17,44,108
277,Jarell Martin\martija01,PF,23,MEM,27,12,445,42,115,.365,8,32,.250,34,83,.410,.400,16,20,.800,23,56,79,11,15,19,22,71,108
278,Tim Frazier\fraziti01,PG,27,WAS,29,11,496,41,100,.410,11,34,.324,30,66,.455,.465,14,16,.875,9,58,67,104,25,3,38,53,107
279,Malcolm Delaney\delanma01,PG,28,ATL,21,2,381,36,96,.375,13,39,.333,23,57,.404,.443,21,30,.700,5,32,37,41,14,2,23,25,106
280,Davis Bertans\bertada01,PF,25,SAS,25,0,235,37,83,.446,24,64,.375,13,19,.684,.590,8,10,.800,4,30,34,13,6,8,10,23,106
281,Tyler Cavanaugh\cavanty01,PF,23,ATL,19,1,262,38,75,.507,18,44,.409,20,31,.645,.627,10,13,.769,21,40,61,21,5,2,8,32,104
282,Ian Mahinmi\mahinia01,C,31,WAS,27,0,408,35,73,.479,0,0,,35,73,.479,.479,33,43,.767,50,55,105,17,13,12,32,87,103
283,Tony Allen\allento01,SG,36,NOP,22,0,273,44,91,.484,4,12,.333,40,79,.506,.505,11,21,.524,20,27,47,9,11,3,19,49,103
284,Jawun Evans\evansja01,PG,21,LAC,20,0,298,37,104,.356,6,24,.250,31,80,.388,.385,22,27,.815,2,31,33,33,16,3,18,37,102
285,Jordan Bell\belljo01,C,23,GSW,23,4,273,50,67,.746,0,0,,50,67,.746,.746,2,4,.500,24,50,74,32,14,23,18,37,102
286,Brandon Paul\paulbr01,SG,26,SAS,29,2,347,35,75,.467,13,37,.351,22,38,.579,.553,17,25,.680,2,33,35,28,19,5,18,37,100
287,Nikola Mirotic\mirotni01,PF,26,CHI,5,3,131,35,65,.538,15,30,.500,20,35,.571,.654,15,22,.682,6,25,31,2,3,2,4,10,100
288,Derrick Rose\rosede01,PG,29,CLE,7,7,188,39,83,.470,3,13,.231,36,70,.514,.488,19,21,.905,7,11,18,12,2,1,19,11,100
289,Richaun Holmes\holmeri01,C,24,PHI,14,2,218,41,74,.554,3,16,.188,38,58,.655,.574,14,19,.737,19,48,67,12,5,6,7,33,99
290,Shelvin Mack\macksh01,PG,27,ORL,23,2,407,36,99,.364,10,30,.333,26,69,.377,.414,16,25,.640,8,40,48,96,14,2,22,24,98
291,Jarrett Allen\allenja01,C,19,BRK,19,0,309,39,73,.534,1,2,.500,38,71,.535,.541,18,25,.720,26,43,69,9,10,18,9,35,97
292,Malik Beasley\beaslma01,SG,21,DEN,26,0,282,37,91,.407,11,37,.297,26,54,.481,.467,12,18,.667,9,35,44,16,4,2,14,19,97
293,Dwayne Bacon\bacondw01,SG,22,CHO,26,6,438,39,107,.364,10,29,.345,29,78,.372,.411,9,13,.692,1,82,83,20,8,2,14,36,97
294,Timofey Mozgov\mozgoti01,C,31,BRK,21,14,285,38,69,.551,3,17,.176,35,52,.673,.572,16,22,.727,27,57,84,5,3,9,26,29,95
295,Paul Zipser\zipsepa01,SF,23,CHI,25,7,403,38,120,.317,14,49,.286,24,71,.338,.375,5,10,.500,5,71,76,26,10,4,22,38,95
296,Noah Vonleh\vonleno01,PF,22,POR,21,12,411,38,73,.521,0,0,,38,73,.521,.521,17,23,.739,34,109,143,12,6,11,12,37,93
297,Sam Dekker\dekkesa01,SF,23,LAC,23,0,281,37,99,.374,7,42,.167,30,57,.526,.409,12,17,.706,12,39,51,9,9,6,12,24,93
298,Patrick McCaw\mccawpa01,SG,22,GSW,25,1,351,34,71,.479,13,33,.394,21,38,.553,.570,9,11,.818,5,16,21,37,17,4,10,25,90
299,Treveon Graham\grahatr01,SG,24,CHO,18,0,309,32,71,.451,12,30,.400,20,41,.488,.535,12,15,.800,14,25,39,24,10,1,10,35,88
300,Shabazz Muhammad\muhamsh01,SF,25,MIN,22,2,250,35,91,.385,4,19,.211,31,72,.431,.407,13,18,.722,12,26,38,7,5,2,3,19,87
301,JaVale McGee\mcgeeja01,C,30,GSW,25,2,197,36,66,.545,0,3,.000,36,63,.571,.545,14,18,.778,17,32,49,13,8,18,9,31,86
302,Jose Calderon\caldejo01,PG,36,CLE,20,14,335,30,60,.500,19,37,.514,11,23,.478,.658,7,8,.875,4,22,26,38,13,0,16,29,86
303,Brandan Wright\wrighbr03,PF,30,MEM,16,0,229,35,63,.556,0,0,,35,63,.556,.556,15,23,.652,20,35,55,5,8,18,3,16,85
304,Cristiano Felicio\feliccr01,C,25,CHI,21,0,310,36,58,.621,0,0,,36,58,.621,.621,13,22,.591,24,37,61,13,4,4,15,42,85
305,Mario Hezonja\hezonma01,SF,22,ORL,23,3,284,32,77,.416,11,36,.306,21,41,.512,.487,10,12,.833,10,42,52,18,9,5,18,29,85
306,Shane Larkin\larkish01,PG,25,BOS,22,0,242,29,79,.367,11,32,.344,18,47,.383,.437,15,18,.833,3,21,24,27,11,1,5,24,84
307,Raul Neto\netora01,PG,25,UTA,17,0,226,33,70,.471,10,22,.455,23,48,.479,.543,8,13,.615,2,21,23,33,6,2,12,14,84
308,T.J. Leaf\leaftj01,PF,20,IND,25,0,242,34,74,.459,11,23,.478,23,51,.451,.534,3,7,.429,17,26,43,5,5,2,6,26,82
309,Patrick Patterson\pattepa01,PF,28,OKC,28,0,387,28,75,.373,19,52,.365,9,23,.391,.500,6,6,1.000,7,44,51,14,16,4,11,29,81
310,DeAndre' Bembry\bembrde01,SF,23,ATL,15,0,268,31,79,.392,5,16,.313,26,63,.413,.424,12,19,.632,5,30,35,22,11,8,30,25,79
311,Sean Kilpatrick\kilpase01,SG,28,BRK,16,0,183,25,86,.291,11,42,.262,14,44,.318,.355,18,19,.947,1,34,35,15,2,1,16,8,79
312,Michael Carter-Williams\cartemi01,PG,26,CHO,17,2,287,21,77,.273,5,15,.333,16,62,.258,.305,31,38,.816,13,37,50,41,15,4,23,35,78
313,Antonio Blakeney\blakean01,SG,21,CHI,11,0,163,28,77,.364,8,28,.286,20,49,.408,.416,14,19,.737,3,17,20,7,2,0,8,8,78
314,Josh Hart\hartjo01,SG,22,LAL,22,1,325,28,65,.431,10,29,.345,18,36,.500,.508,12,16,.750,8,48,56,11,13,5,10,20,78
315,Semi Ojeleye\ojelese01,PF,23,BOS,30,0,436,25,79,.316,17,62,.274,8,17,.471,.424,10,17,.588,18,48,66,6,11,0,10,30,77
316,Isaiah Whitehead\whiteis01,PG,22,BRK,10,0,142,30,63,.476,5,12,.417,25,51,.490,.516,11,17,.647,3,17,20,18,7,2,22,16,76
317,Willy Hernangomez\hernawi01,C,23,NYK,14,0,153,35,61,.574,1,4,.250,34,57,.596,.582,4,15,.267,19,32,51,13,5,6,19,25,75
318,Jonathan Isaac\isaacjo01,PF,20,ORL,12,2,239,28,61,.459,5,17,.294,23,44,.523,.500,12,14,.857,11,42,53,10,8,15,12,25,73
319,Nerlens Noel\noelne01,C,23,DAL,18,6,225,28,53,.528,0,0,,28,53,.528,.528,16,19,.842,26,47,73,6,10,10,15,31,72
320,Al Jefferson\jeffeal01,C,33,IND,10,0,139,31,57,.544,0,1,.000,31,56,.554,.544,10,12,.833,11,36,47,11,5,7,8,18,72
321,Matthew Dellavedova\dellama01,PG,27,MIL,13,1,260,25,66,.379,11,29,.379,14,37,.378,.462,10,11,.909,7,21,28,41,3,0,21,24,71
322,Mirza Teletovic\teletmi01,PF,32,MIL,10,0,159,25,57,.439,21,45,.467,4,12,.333,.623,0,0,,3,20,23,10,4,1,7,14,71
323,Ekpe Udoh\udohek01,C,30,UTA,26,0,388,26,55,.473,0,0,,26,55,.473,.473,17,21,.810,33,32,65,30,17,34,12,54,69
324,Corey Brewer\breweco01,SF,31,LAL,27,1,306,27,61,.443,3,17,.176,24,44,.545,.467,12,18,.667,5,27,32,19,21,4,14,36,69
325,Salah Mejri\mejrisa01,C,31,DAL,24,1,267,28,40,.700,0,2,.000,28,38,.737,.700,12,23,.522,29,65,94,11,7,30,11,42,68
326,Meyers Leonard\leoname01,PF,25,POR,11,2,129,27,45,.600,7,13,.538,20,32,.625,.678,6,8,.750,5,27,32,6,2,0,3,19,67
327,Joffrey Lauvergne\lauvejo01,C,26,SAS,15,0,168,29,57,.509,0,3,.000,29,54,.537,.509,8,14,.571,21,31,52,11,5,0,10,20,66
328,Lucas Nogueira\noguelu01,C,25,TOR,17,2,204,28,47,.596,3,10,.300,25,37,.676,.628,7,9,.778,9,37,46,6,11,20,9,27,66
329,Deyonta Davis\davisde01,C,21,MEM,16,0,190,28,47,.596,0,0,,28,47,.596,.596,7,11,.636,15,38,53,8,5,11,6,28,63
330,Iman Shumpert\shumpim01,SG,27,CLE,13,6,271,22,57,.386,7,25,.280,15,32,.469,.447,11,15,.733,7,33,40,17,9,5,17,20,62
331,Tony Parker\parketo01,PG,35,SAS,8,8,148,26,55,.473,0,4,.000,26,51,.510,.473,8,12,.667,2,19,21,33,3,1,11,6,60
332,Josh Huestis\huestjo01,PF,26,OKC,22,0,257,22,57,.386,14,40,.350,8,17,.471,.509,2,7,.286,9,28,37,7,7,10,13,32,60
333,Mike Muscala\muscami01,C,26,ATL,9,5,202,21,51,.412,6,19,.316,15,32,.469,.471,11,12,.917,11,29,40,9,7,5,8,23,59
334,Johnny O'Bryant\obryajo01,PF,24,CHO,14,0,121,23,63,.365,3,14,.214,20,49,.408,.389,10,10,1.000,10,22,32,5,5,3,6,11,59
335,Reggie Bullock\bullore01,SF,26,DET,15,6,253,23,54,.426,8,28,.286,15,26,.577,.500,4,7,.571,5,11,16,12,15,3,3,12,58
336,Tarik Black\blackta01,C,26,HOU,20,0,165,23,44,.523,0,7,.000,23,37,.622,.523,11,18,.611,17,35,52,6,7,9,11,38,57
337,Kevon Looney\looneke01,C,21,GSW,22,0,214,24,45,.533,0,0,,24,45,.533,.533,8,18,.444,19,37,56,9,7,16,13,40,56
338,Arron Afflalo\afflaar01,SG,32,ORL,22,2,300,20,57,.351,6,25,.240,14,32,.438,.404,10,14,.714,3,32,35,11,1,4,8,25,56
339,Juan Hernangomez\hernaju01,PF,22,DEN,15,3,204,19,51,.373,11,35,.314,8,16,.500,.480,7,9,.778,14,26,40,8,4,2,6,18,56
340,Kay Felder\feldeka01,PG,22,CHI,14,0,134,20,66,.303,4,18,.222,16,48,.333,.333,11,12,.917,1,13,14,20,3,1,15,11,55
341,DeAndre Liggins\liggide01,SG,29,MIL,24,0,375,21,58,.362,11,31,.355,10,27,.370,.457,2,5,.400,3,30,33,17,20,8,12,45,55
342,Vince Carter\cartevi01,SF,41,SAC,18,0,238,20,61,.328,10,34,.294,10,27,.370,.410,3,7,.429,3,22,25,14,9,8,6,22,53
343,Rashad Vaughn\vaughra01,SG,21,MIL,15,0,155,19,46,.413,11,31,.355,8,15,.533,.533,4,6,.667,1,12,13,12,4,2,1,12,53
344,Boban Marjanovic\marjabo01,C,29,DET,8,0,62,18,30,.600,0,0,,18,30,.600,.600,16,22,.727,8,9,17,5,2,1,10,17,52
345,Jared Dudley\dudleja01,PF,32,PHO,12,0,183,16,37,.432,10,24,.417,6,13,.462,.568,9,11,.818,5,26,31,26,7,2,7,25,51
346,Justin Anderson\anderju01,SF,24,PHI,10,0,126,18,48,.375,9,26,.346,9,22,.409,.469,5,7,.714,10,17,27,3,3,1,4,19,50
347,Damyean Dotson\dotsoda01,SG,23,NYK,17,2,159,21,46,.457,6,20,.300,15,26,.577,.522,2,3,.667,3,21,24,7,2,1,3,11,50
348,Jamil Wilson\wilsoja02,SF,27,LAC,9,4,132,18,39,.462,11,28,.393,7,11,.636,.603,2,4,.500,3,12,15,8,0,3,6,15,49
349,Royce O'Neale\onealro01,SF,24,UTA,19,0,199,16,47,.340,7,24,.292,9,23,.391,.415,9,14,.643,3,33,36,20,8,1,7,16,48
350,C.J. Williams\willicj01,SG,27,LAC,15,1,175,19,44,.432,7,14,.500,12,30,.400,.511,3,4,.750,5,14,19,13,7,1,5,14,48
351,Malachi Richardson\richama01,SG,22,SAC,13,0,146,15,43,.349,7,19,.368,8,24,.333,.430,10,13,.769,2,10,12,6,7,0,4,14,47
352,Joe Johnson\johnsjo02,SF,36,UTA,8,0,149,19,49,.388,2,17,.118,17,32,.531,.408,7,9,.778,4,18,22,11,4,2,12,7,47
353,Henry Ellenson\ellenhe01,PF,21,DET,11,0,94,19,46,.413,8,20,.400,11,26,.423,.500,1,1,1.000,2,23,25,6,3,0,8,8,47
354,Ramon Sessions\sessira01,PG,31,NYK,10,3,149,16,49,.327,2,11,.182,14,38,.368,.347,12,15,.800,1,13,14,27,7,1,14,13,46
355,Bobby Brown\brownbo02,PG,33,HOU,18,0,107,17,54,.315,11,38,.289,6,16,.375,.417,1,2,.500,0,7,7,10,3,0,8,6,46
356,Quincy Pondexter\pondequ01,SF,29,CHI,16,1,162,13,43,.302,3,20,.150,10,23,.435,.337,14,17,.824,8,12,20,7,7,2,11,21,43
357,Jon Leuer\leuerjo01,PF,28,DET,8,0,136,15,36,.417,0,3,.000,15,33,.455,.417,13,15,.867,7,25,32,5,1,3,8,16,43
358,Joe Young\youngjo01,PG,25,IND,15,0,88,17,38,.447,1,11,.091,16,27,.593,.461,6,10,.600,3,8,11,8,1,0,6,8,41
359,Jason Smith\smithja02,C,31,WAS,12,2,131,15,47,.319,1,17,.059,14,30,.467,.330,9,9,1.000,12,10,22,2,2,7,8,24,40
360,Cheick Diallo\diallch01,PF,21,NOP,15,0,109,18,32,.563,0,0,,18,32,.563,.563,3,6,.500,8,25,33,3,0,1,7,20,39
361,Cedi Osman\osmande01,SF,22,CLE,21,0,143,16,34,.471,5,16,.313,11,18,.611,.544,2,2,1.000,3,31,34,4,4,1,7,23,39
362,Caleb Swanigan\swanica01,PF,20,POR,14,3,129,14,40,.350,1,5,.200,13,35,.371,.363,8,13,.615,12,24,36,9,5,3,11,24,37
363,Miles Plumlee\plumlmi01,C,29,ATL,10,7,158,16,30,.533,0,0,,16,30,.533,.533,5,12,.417,11,22,33,6,6,4,12,14,37
364,Ron Baker\bakerro01,SG,24,NYK,10,0,148,9,22,.409,6,12,.500,3,10,.300,.545,12,17,.706,1,6,7,24,12,3,9,11,36
365,Tristan Thompson\thomptr01,C,26,CLE,9,5,179,15,26,.577,0,0,,15,26,.577,.577,5,11,.455,17,34,51,3,1,4,6,16,35
366,Milos Teodosic\teodomi01,PG,30,LAC,4,4,78,10,33,.303,7,21,.333,3,12,.250,.409,4,4,1.000,1,13,14,14,1,2,6,8,31
367,Aaron Brooks\brookaa01,PG,33,MIN,12,1,56,12,23,.522,6,11,.545,6,12,.500,.652,1,2,.500,2,5,7,8,1,0,3,7,31
368,Eric Moreland\moreler01,PF,26,DET,25,0,268,13,27,.481,0,0,,13,27,.481,.481,4,10,.400,33,54,87,19,8,19,13,46,30
369,Zach Collins\colliza01,C,20,POR,12,1,122,13,40,.325,2,10,.200,11,30,.367,.350,2,6,.333,10,14,24,6,3,6,10,23,30
370,JaKarr Sampson\sampsja02,SF,24,SAC,6,2,102,13,22,.591,2,3,.667,11,19,.579,.636,2,2,1.000,8,22,30,2,2,4,2,17,30
371,Dakari Johnson\johnsda04,C,22,OKC,12,3,77,10,21,.476,0,0,,10,21,.476,.476,7,12,.583,8,5,13,5,3,4,2,16,27
372,Quinn Cook\cookqu01,PG,24,GSW,7,1,76,11,20,.550,4,11,.364,7,9,.778,.650,1,1,1.000,1,6,7,12,0,0,3,7,27
373,Nik Stauskas\stausni01,SG,24,TOT,7,0,73,7,13,.538,5,8,.625,2,5,.400,.731,7,7,1.000,0,8,8,3,4,0,6,3,26
374,Wesley Iwundu\iwundwe01,SF,23,ORL,12,1,135,12,38,.316,1,6,.167,11,32,.344,.329,1,3,.333,3,14,17,8,2,0,4,8,26
375,Dorian Finney-Smith\finnedo01,PF,24,DAL,8,1,94,10,22,.455,5,14,.357,5,8,.625,.568,1,2,.500,5,5,10,5,0,1,7,13,26
376,Gary Payton\paytoga02,PG,25,MIL,11,6,100,12,31,.387,2,11,.182,10,20,.500,.419,0,1,.000,3,12,15,7,3,1,3,13,26
377,Terrance Ferguson\fergute01,SG,19,OKC,18,0,128,11,27,.407,2,14,.143,9,13,.692,.444,1,2,.500,3,4,7,1,4,1,3,15,25
378,Kawhi Leonard\leonaka01,SF,26,SAS,2,2,33,11,21,.524,2,6,.333,9,15,.600,.571,1,1,1.000,2,8,10,2,3,3,2,0,25
379,Markelle Fultz\fultzma01,SG,19,PHI,4,0,76,9,27,.333,0,0,,9,27,.333,.333,6,12,.500,3,6,9,7,2,1,6,6,24
380,Jordan Mickey\mickejo01,PF,23,MIA,7,2,61,10,18,.556,0,3,.000,10,15,.667,.556,4,5,.800,4,23,27,1,1,3,4,7,24
381,Abdel Nader\naderab01,SF,24,BOS,14,0,101,10,28,.357,4,14,.286,6,14,.429,.429,0,1,.000,2,9,11,4,3,3,6,8,24
382,Chris McCullough\mcculch01,PF,22,WAS,7,0,47,8,21,.381,1,5,.200,7,16,.438,.405,5,8,.625,4,9,13,1,0,2,0,7,22
383,Tyler Dorsey\dorsety01,SG,21,ATL,10,0,63,7,20,.350,5,14,.357,2,6,.333,.475,3,4,.750,1,7,8,3,1,1,5,1,22
384,Jake Layman\laymaja01,SF,23,POR,13,0,83,9,28,.321,2,11,.182,7,17,.412,.357,2,2,1.000,2,8,10,2,3,2,1,9,22
385,Tyler Ennis\ennisty01,PG,23,LAL,12,0,66,8,22,.364,0,5,.000,8,17,.471,.364,4,4,1.000,1,8,9,9,4,1,4,7,20
386,Jahlil Okafor\okafoja01,C,22,TOT,3,0,48,9,20,.450,0,2,.000,9,18,.500,.450,2,4,.500,5,8,13,1,1,2,5,9,20
387,Okaro White\whiteok01,PF,25,MIA,6,4,80,7,16,.438,4,11,.364,3,5,.600,.563,2,3,.667,3,8,11,2,1,1,1,6,20
388,Gian Clavell\clavegi01,SG,24,DAL,7,0,64,6,18,.333,6,15,.400,0,3,.000,.500,2,2,1.000,1,6,7,3,2,0,2,8,20
389,Guerschon Yabusele\yabusgu01,PF,22,BOS,10,0,52,7,17,.412,4,11,.364,3,6,.500,.529,2,2,1.000,8,8,16,4,0,1,3,6,20
390,Jeremy Lin\linje01,PG,29,BRK,1,1,25,5,12,.417,1,2,.500,4,10,.400,.458,7,7,1.000,0,0,0,4,0,0,3,3,18
391,Andrew Bogut\bogutan01,C,33,LAL,16,0,123,9,15,.600,0,0,,9,15,.600,.600,0,0,,12,34,46,10,4,10,11,20,18
392,Jordan Crawford\crawfjo02,SG,29,NOP,2,0,37,7,14,.500,4,5,.800,3,9,.333,.643,0,0,,2,1,3,9,0,1,4,6,18
393,Zhou Qi\qizh01,C,22,HOU,13,0,64,4,21,.190,2,12,.167,2,9,.222,.238,7,8,.875,2,10,12,1,2,6,4,9,17
394,Damien Wilkins\wilkida02,SF,38,IND,14,0,89,8,19,.421,0,8,.000,8,11,.727,.421,1,2,.500,4,6,10,6,2,0,4,5,17
395,Georgios Papagiannis\papagge01,C,20,SAC,5,0,35,8,10,.800,0,0,,8,10,.800,.800,0,0,,2,6,8,2,1,1,1,3,16
396,Jason Terry\terryja01,SG,40,MIL,10,0,111,6,19,.316,1,12,.083,5,7,.714,.342,2,2,1.000,0,9,9,6,7,4,4,7,15
397,Jeff Withey\witheje01,C,27,DAL,10,0,39,6,16,.375,2,10,.200,4,6,.667,.438,1,2,.500,1,9,10,0,0,3,2,3,15
398,Brice Johnson\johnsbr02,PF,23,LAC,8,0,34,6,10,.600,0,1,.000,6,9,.667,.600,2,2,1.000,1,10,11,1,5,1,4,7,14
399,Ante Zizic\zizican01,C,21,CLE,11,1,39,4,11,.364,0,0,,4,11,.364,.364,5,7,.714,5,8,13,1,0,3,2,4,13
400,Josh Magette\magetjo01,PG,28,ATL,8,0,64,4,12,.333,1,4,.250,3,8,.375,.375,4,4,1.000,1,5,6,17,2,0,2,6,13
401,Kyle Singler\singlky01,SF,29,OKC,4,0,32,4,12,.333,2,4,.500,2,8,.250,.417,2,5,.400,0,4,4,0,0,0,2,3,12
402,Sterling Brown\brownst02,SG,22,MIL,6,0,35,5,13,.385,2,5,.400,3,8,.375,.462,0,0,,2,4,6,2,2,1,1,6,12
403,Richard Jefferson\jefferi01,SF,37,DEN,8,0,56,4,13,.308,1,5,.200,3,8,.375,.346,2,5,.400,0,3,3,7,0,0,0,3,11
404,Alfonzo McKinnie\mckinal01,SF,25,TOR,9,0,33,4,7,.571,1,4,.250,3,3,1.000,.643,2,3,.667,0,5,5,1,1,1,1,6,11
405,Omer Asik\asikom01,C,31,NOP,8,0,72,5,11,.455,0,0,,5,11,.455,.455,1,2,.500,3,18,21,2,0,0,2,5,11
406,Antonius Cleveland\clevean01,SG,23,DAL,11,0,78,4,14,.286,0,1,.000,4,13,.308,.286,2,4,.500,2,8,10,2,6,4,2,10,10
407,Derrick White\whitede01,PG,23,SAS,6,0,47,3,7,.429,0,0,,3,7,.429,.429,3,6,.500,2,7,9,3,3,2,3,5,9
408,Joel Bolomboy\bolomjo01,PF,24,MIL,6,0,38,3,6,.500,0,1,.000,3,5,.600,.500,3,6,.500,6,4,10,0,2,0,2,3,9
409,Derrick Jones\jonesde02,SF,20,PHO,6,0,33,2,4,.500,0,2,.000,2,2,1.000,.500,5,6,.833,2,2,4,3,1,4,1,2,9
410,Furkan Korkmaz\korkmfu01,SG,20,PHI,6,0,32,3,12,.250,1,8,.125,2,4,.500,.292,2,2,1.000,2,4,6,2,1,0,1,4,9
411,Marcus Georges-Hunt\georgma01,SG,23,MIN,10,0,32,4,7,.571,1,3,.333,3,4,.750,.643,0,0,,1,1,2,2,1,0,2,4,9
412,Nick Collison\collini01,PF,37,OKC,5,0,24,3,4,.750,0,0,,3,4,.750,.750,2,2,1.000,3,5,8,3,0,0,2,3,8
413,Demetrius Jackson\jacksde01,PG,23,HOU,12,0,63,4,14,.286,0,6,.000,4,8,.500,.286,0,0,,4,7,11,5,4,1,10,6,8
414,D.J. Wilson\wilsodj01,PF,21,MIL,11,0,40,4,9,.444,0,3,.000,4,6,.667,.444,0,0,,0,5,5,1,0,0,2,4,8
415,Wayne Selden\seldewa01,SG,23,MEM,2,0,19,2,4,.500,1,2,.500,1,2,.500,.625,2,2,1.000,0,2,2,4,1,0,3,0,7
416,Darrell Arthur\arthuda01,PF,29,DEN,4,0,38,3,13,.231,1,9,.111,2,4,.500,.269,0,0,,1,4,5,1,2,0,7,6,7
417,Torrey Craig\craigto01,SF,27,DEN,2,1,25,2,7,.286,1,5,.200,1,2,.500,.357,1,2,.500,0,5,5,2,1,2,1,2,6
418,Alex Poythress\poythal01,PF,24,IND,7,0,20,2,3,.667,2,2,1.000,0,1,.000,1.000,0,0,,0,4,4,0,0,0,1,1,6
419,Julyan Stone\stoneju01,SG,29,CHO,2,0,18,2,4,.500,2,4,.500,0,0,,.750,0,0,,0,5,5,2,2,0,2,3,6
420,Jabari Bird\birdja01,SG,23,BOS,3,0,21,1,4,.250,0,2,.000,1,2,.500,.250,3,5,.600,0,2,2,1,1,0,0,1,5
421,Troy Williams\willitr02,SF,23,HOU,4,0,17,2,9,.222,0,5,.000,2,4,.500,.222,1,3,.333,1,3,4,1,1,0,1,2,5
422,Jalen Jones\jonesja04,SF,24,NOP,4,0,19,1,4,.250,1,1,1.000,0,3,.000,.375,2,2,1.000,0,3,3,0,0,0,0,2,5
423,Joakim Noah\noahjo01,C,32,NYK,2,0,11,2,3,.667,0,0,,2,3,.667,.667,1,2,.500,2,3,5,3,1,1,1,1,5
424,James Michael McAdoo\mcadoja01,PF,25,PHI,1,0,7,1,4,.250,1,4,.250,0,0,,.375,2,2,1.000,0,0,0,0,0,0,1,0,5
425,Johnathan Motley\motlejo01,PF,22,DAL,1,0,2,1,1,1.000,0,0,,1,1,1.000,1.000,2,4,.500,0,1,1,0,0,1,0,0,4
426,Jacob Wiley\wileyja01,PF,23,BRK,5,0,33,1,4,.250,1,2,.500,0,2,.000,.375,1,2,.500,2,9,11,2,1,0,0,4,4
427,Danuel House\houseda01,SG,24,PHO,2,0,31,1,6,.167,0,3,.000,1,3,.333,.167,2,2,1.000,0,2,2,1,0,0,1,1,4
428,Tony Bradley\bradlto01,C,20,UTA,7,0,21,1,9,.111,0,1,.000,1,8,.125,.111,2,2,1.000,3,5,8,1,0,0,0,1,4
429,Ike Anigbogu\anigbik01,C,19,IND,6,0,17,1,5,.200,0,0,,1,5,.200,.200,2,2,1.000,2,2,4,0,1,1,2,1,4
430,Lorenzo Brown\brownlo01,PG,27,TOR,8,0,55,2,9,.222,0,4,.000,2,5,.400,.222,0,0,,0,8,8,5,4,0,0,3,4
431,Ivica Zubac\zubaciv01,C,20,LAL,6,0,14,2,5,.400,0,0,,2,5,.400,.400,0,0,,2,2,4,0,0,0,2,2,4
432,Khem Birch\birchkh01,C,25,ORL,4,0,11,2,5,.400,0,0,,2,5,.400,.400,0,0,,2,0,2,1,0,0,0,3,4
433,Vince Hunter\huntevi01,PF,23,MEM,2,0,5,2,2,1.000,0,0,,2,2,1.000,1.000,0,0,,1,1,2,0,0,0,1,0,4
434,Darrun Hilliard\hillida01,SG,24,SAS,4,0,39,1,7,.143,0,2,.000,1,5,.200,.143,1,2,.500,0,3,3,4,2,0,3,4,3
435,Cole Aldrich\aldrico01,C,29,MIN,6,0,13,1,3,.333,0,0,,1,3,.333,.333,1,2,.500,0,1,1,1,2,0,0,2,3
436,John Holland\hollajo02,SF,29,CLE,4,0,17,1,4,.250,1,2,.500,0,2,.000,.375,0,0,,0,2,2,0,0,0,1,0,3
437,Alec Peters\peteral01,PF,22,PHO,2,0,14,1,4,.250,1,4,.250,0,0,,.375,0,0,,0,3,3,0,0,2,0,1,3
438,Derrick Walton\waltode01,PG,22,MIA,4,0,12,0,3,.000,0,1,.000,0,2,.000,.000,2,2,1.000,0,2,2,0,1,1,0,0,2
439,Jack Cooley\cooleja01,PF,26,SAC,1,0,2,0,1,.000,0,0,,0,1,.000,.000,2,2,1.000,0,1,1,1,0,0,0,0,2
440,Vander Blue\blueva01,SG,25,LAL,4,0,28,1,3,.333,0,0,,1,3,.333,.333,0,0,,0,1,1,1,0,0,2,2,2
441,Alex Caruso\carusal01,PG,23,LAL,2,0,19,1,2,.500,0,0,,1,2,.500,.500,0,0,,0,2,2,4,0,0,2,0,2
442,Luol Deng\denglu01,SF,32,LAL,1,1,13,1,2,.500,0,0,,1,2,.500,.500,0,0,,0,0,0,1,1,0,1,0,2
443,Josh Smith\smithjo03,PF,32,NOP,3,0,12,1,4,.250,0,0,,1,4,.250,.250,0,0,,3,1,4,0,0,0,0,3,2
444,Matt Costello\costema01,C,24,SAS,1,0,11,1,1,1.000,0,0,,1,1,1.000,1.000,0,0,,0,5,5,0,0,2,0,3,2
445,Udonis Haslem\hasleud01,C,37,MIA,3,0,10,1,1,1.000,0,0,,1,1,1.000,1.000,0,0,,0,1,1,2,0,0,0,1,2
446,Gordon Hayward\haywago01,SF,27,BOS,1,1,5,1,2,.500,0,1,.000,1,1,1.000,.500,0,0,,0,1,1,0,0,0,0,1,2
447,Charles Cooke\cookech01,SG,23,NOP,3,0,5,1,4,.250,0,2,.000,1,2,.500,.250,0,0,,0,0,0,1,1,0,0,0,2
448,Kobi Simmons\simmoko01,PG,20,MEM,1,0,5,1,1,1.000,0,0,,1,1,1.000,1.000,0,0,,0,0,0,0,0,0,0,1,2
449,Kadeem Allen\allenka01,PG,25,BOS,1,0,5,0,1,.000,0,1,.000,0,0,,.000,1,2,.500,1,1,2,0,0,0,1,0,1
450,Briante Weber\weberbr01,PG,25,HOU,4,0,14,0,0,,0,0,,0,0,,,0,0,,0,3,3,1,1,0,1,1,0
451,Nate Wolters\woltena01,PG,26,UTA,4,0,11,0,3,.000,0,0,,0,3,.000,.000,0,0,,1,1,2,1,0,0,0,1,0
452,Nicolas Brussino\brussni01,SF,24,ATL,4,0,10,0,2,.000,0,2,.000,0,0,,.000,0,0,,0,3,3,0,0,0,0,0,0
453,Bruno Caboclo\cabocbr01,SF,22,TOR,2,0,7,0,2,.000,0,2,.000,0,0,,.000,0,0,,0,1,1,1,1,0,0,1,0
454,Ryan Arcidiacono\arcidry01,PG,23,CHI,1,0,5,0,2,.000,0,2,.000,0,0,,.000,0,0,,0,0,0,1,0,0,0,1,0
455,Isaiah Canaan\canaais01,SG,26,HOU,1,0,4,0,1,.000,0,0,,0,1,.000,.000,0,0,,0,1,1,0,0,0,0,0,0
456,Daniel Hamilton\hamilda02,SG,22,OKC,1,0,4,0,1,.000,0,0,,0,1,.000,.000,0,0,,0,0,0,0,0,0,0,0,0
457,Mangok Mathiang\mathima01,C,25,CHO,1,0,3,0,2,.000,0,0,,0,2,.000,.000,0,0,,1,1,2,0,0,0,0,0,0
458,Monte Morris\morrimo01,PG,22,DEN,1,0,3,0,1,.000,0,1,.000,0,0,,.000,0,0,,0,0,0,1,0,0,0,0,0
459,Marcus Paige\paigema01,PG,24,CHO,1,0,3,0,2,.000,0,0,,0,2,.000,.000,0,0,,0,2,2,0,0,0,0,0,0
460,London Perrantes\perralo01,PG,23,CLE,1,0,3,0,1,.000,0,0,,0,1,.000,.000,0,0,,0,0,0,0,0,0,0,1,0
461,Ivan Rabb\rabbiv01,PF,20,MEM,2,0,3,0,1,.000,0,0,,0,1,.000,.000,0,0,,0,0,0,1,0,0,0,0,0
462,Mindaugas Kuzminskas\kuzmimi01,SF,28,NYK,1,0,2,0,2,.000,0,0,,0,2,.000,.000,0,0,,0,0,0,0,0,0,0,0,0
463,Tyler Lydon\lydonty01,PF,21,DEN,1,0,2,0,0,,0,0,,0,0,,,0,0,,0,0,0,0,0,0,0,0,0
464,Jacob Pullen\pulleja01,PG,28,PHI,2,0,2,0,1,.000,0,1,.000,0,0,,.000,0,0,,0,0,0,0,0,0,0,0,0
465,Jamel Artis\artisja01,SG,25,ORL,1,0,1,0,1,.000,0,0,,0,1,.000,.000,0,0,,0,0,0,0,0,0,0,0,0
466,Adreian Payne\paynead01,PF,26,ORL,1,0,1,0,0,,0,0,,0,0,,,0,0,,0,0,0,0,0,0,0,0,0